7 20
|------------------|
|..........P.F.....|
|F.......@.......F.|
|.................F|
|..................|
|..................|
|------------------|
