11 29
|---------------------------|
|F..........................|
|...........----............|
|---............F...........|
|...........................|
|.............@.....|.......|
|...|...............|..F....|
|...|...F...........|.......|
|...........................|
|...............P...........|
|---------------------------|
